Date,"Transaction ID:",Details,Turnover,Balance,Currency
"2018-09-19 16:00:03",438965073,Deposits,500,500,EUR
"2018-09-19 16:00:14",438965112,"Loan 4714107-02 - investment in loan  ",-10,490,EUR
"2018-09-19 16:00:16",438965114,"Loan 5502382-01 - investment in loan  ",-10,480,EUR
"2018-09-19 16:00:17",438965116,"Loan 5502375-01 - investment in loan  ",-10,470,EUR
"2018-09-19 16:00:18",438965119,"Loan 5502385-01 - investment in loan  ",-10,460,EUR
"2018-09-19 16:00:19",438965121,"Loan 5502404-01 - investment in loan  ",-10,450,EUR
"2018-09-19 16:00:21",438965124,"Loan 5503213-01 - investment in loan  ",-10,440,EUR
"2018-09-19 16:00:22",438965126,"Loan 5503218-01 - investment in loan  ",-10,430,EUR
"2018-09-19 16:00:23",438965129,"Loan 5503217-01 - investment in loan  ",-10,420,EUR
"2018-09-19 16:00:24",438965131,"Loan 5502380-01 - investment in loan  ",-10,410,EUR
"2018-09-19 16:00:25",438965134,"Loan 5503223-01 - investment in loan  ",-10,400,EUR
"2018-09-19 16:00:27",438965136,"Loan 5502390-01 - investment in loan  ",-10,390,EUR
"2018-09-19 16:00:28",438965139,"Loan 5503211-01 - investment in loan  ",-10,380,EUR
"2018-09-19 16:00:29",438965141,"Loan 5503220-01 - investment in loan  ",-10,370,EUR
"2018-09-19 16:00:30",438965145,"Loan 5502760-01 - investment in loan  ",-10,360,EUR
"2018-09-19 16:00:32",438965148,"Loan 5503322-01 - investment in loan  ",-10,350,EUR
"2018-09-19 16:00:33",438965151,"Loan 5503354-01 - investment in loan  ",-10,340,EUR
"2018-09-19 16:00:34",438965153,"Loan 5502836-01 - investment in loan  ",-10,330,EUR
"2018-09-19 16:00:36",438965156,"Loan 5502801-01 - investment in loan  ",-10,320,EUR
"2018-09-19 16:00:37",438965158,"Loan 5502756-01 - investment in loan  ",-10,310,EUR
"2018-09-19 16:00:38",438965160,"Loan 5502562-01 - investment in loan  ",-10,300,EUR
"2018-09-19 16:00:39",438965163,"Loan 5503479-01 - investment in loan  ",-10,290,EUR
"2018-09-19 16:00:41",438965165,"Loan 5503482-01 - investment in loan  ",-10,280,EUR
"2018-09-19 16:00:42",438965168,"Loan 5503179-01 - investment in loan  ",-10,270,EUR
"2018-09-19 16:00:43",438965170,"Loan 5502633-01 - investment in loan  ",-10,260,EUR
"2018-09-19 16:00:44",438965173,"Loan 5503427-01 - investment in loan  ",-10,250,EUR
"2018-09-19 16:00:46",438965175,"Loan 5502850-01 - investment in loan  ",-10,240,EUR
"2018-09-19 16:00:47",438965177,"Loan 5503035-01 - investment in loan  ",-10,230,EUR
"2018-09-19 16:00:48",438965180,"Loan 5502394-01 - investment in loan  ",-10,220,EUR
"2018-09-19 16:00:49",438965182,"Loan 5502816-01 - investment in loan  ",-10,210,EUR
"2018-09-19 16:00:50",438965205,"Loan 5502682-01 - investment in loan  ",-10,200,EUR
"2018-09-19 16:00:52",438965207,"Loan 5503436-01 - investment in loan  ",-10,190,EUR
"2018-09-19 16:00:53",438965211,"Loan 5502678-01 - investment in loan  ",-10,180,EUR
"2018-09-19 16:00:54",438965213,"Loan 5502764-01 - investment in loan  ",-10,170,EUR
"2018-09-19 16:00:55",438965215,"Loan 5503340-01 - investment in loan  ",-10,160,EUR
"2018-09-19 16:00:56",438965218,"Loan 5503033-01 - investment in loan  ",-10,150,EUR
"2018-09-19 16:00:58",438965220,"Loan 5503129-01 - investment in loan  ",-10,140,EUR
"2018-09-19 16:00:59",438965223,"Loan 5503241-01 - investment in loan  ",-10,130,EUR
"2018-09-19 16:01:00",438965225,"Loan 5503160-01 - investment in loan  ",-10,120,EUR
"2018-09-19 16:01:01",438965228,"Loan 5503263-01 - investment in loan  ",-10,110,EUR
"2018-09-19 16:01:03",438965230,"Loan 5502710-01 - investment in loan  ",-10,100,EUR
"2018-09-19 16:01:05",438965233,"Loan 5502592-01 - investment in loan  ",-10,90,EUR
"2018-09-19 16:01:06",438965237,"Loan 5503210-01 - investment in loan  ",-10,80,EUR
"2018-09-19 16:01:07",438965240,"Loan 5502519-01 - investment in loan  ",-10,70,EUR
"2018-09-19 16:01:09",438965244,"Loan 5503188-01 - investment in loan  ",-10,60,EUR
"2018-09-19 16:01:10",438965246,"Loan 5503023-01 - investment in loan  ",-10,50,EUR
"2018-09-19 16:01:11",438965249,"Loan 5502556-01 - investment in loan  ",-10,40,EUR
"2018-09-19 16:01:13",438965251,"Loan 5503111-01 - investment in loan  ",-10,30,EUR
"2018-09-19 16:01:14",438965252,"Loan 5503491-01 - investment in loan  ",-10,20,EUR
"2018-09-19 16:01:15",438965253,"Loan 5502487-01 - investment in loan  ",-10,10,EUR
"2018-09-19 16:01:17",438965254,"Loan 5502615-01 - investment in loan  ",-10,0,EUR
"2018-09-22 23:30:00",442832858,"Loan 5502756-01 - interest received",0.0092499999999987,0.0092499999999987,EUR
"2018-09-22 23:30:00",442832882,"Loan 5502756-01 - principal received",0.13915564413843,0.14840564413843,EUR
"2018-09-22 23:30:00",442836687,"Loan 5502556-01 - interest received",0.0092499999999987,0.15765564413843,EUR
"2018-09-22 23:30:00",442836748,"Loan 5502556-01 - principal received",0.59979388453195,0.75744952867038,EUR
"2018-09-22 23:30:00",442838934,"Loan 5502615-01 - interest received",0.0061666666666658,0.76361619533705,EUR
"2018-09-22 23:30:00",442838941,"Loan 5502615-01 - principal received",1.4388571428571,2.2024733381942,EUR
"2018-09-22 23:30:00",442839094,"Loan 5502764-01 - interest received",0.0080956236011236,2.2105689617953,EUR
"2018-09-22 23:30:00",442841087,"Loan 5502487-01 - interest received",0.0092499999999987,2.2198189617953,EUR
"2018-09-22 23:30:00",442841097,"Loan 5502487-01 - principal received",1.4445714285714,3.6643903903667,EUR
"2018-09-22 23:30:00",442842197,"Loan 5502760-01 - interest received",0.0092499999999987,3.6736403903667,EUR
"2018-09-22 23:30:00",442842210,"Loan 5502760-01 - principal received",1.7812197483059,5.4548601386726,EUR
"2018-09-23 23:30:00",443380771,"Loan 5503033-01 - interest received",0.012333333333332,5.467193472006,EUR
"2018-09-23 23:30:00",443380797,"Loan 5503033-01 - principal received",1.4443544930711,6.9115479650771,EUR
"2018-09-23 23:30:00",443394828,"Loan 5502562-01 - interest received",0.0092499999999987,6.9207979650771,EUR
"2018-09-23 23:30:00",443394842,"Loan 5502562-01 - principal received",0.13938623849678,7.0601842035739,EUR
"2018-09-23 23:30:00",443400680,"Loan 5502764-01 - interest received",0.001154376398,7.0613385799719,EUR
"2018-09-23 23:30:00",443400692,"Loan 5502764-01 - principal received",1.4443544930711,8.505693073043,EUR
"2018-09-23 23:30:00",443400710,"Loan 5502801-01 - interest received",0.0092499999999987,8.514943073043,EUR
"2018-09-23 23:30:00",443400726,"Loan 5502801-01 - principal received",1.4446428571429,9.9595859301858,EUR
"2018-09-24 15:06:04",443638197,Deposits,50,59.959585930186,EUR
"2018-09-24 15:59:31",443643031,"Loan 4546497-03 - investment in loan  ",-10,49.959585930186,EUR
"2018-09-24 15:59:38",443643037,"Loan 4543077-04 - investment in loan  ",-10,39.959585930186,EUR
"2018-09-24 15:59:45",443643044,"Loan 4545328-05 - investment in loan  ",-10,29.959585930186,EUR
"2018-09-24 15:59:54",443643051,"Loan 5569535-01 - investment in loan  ",-10,19.959585930186,EUR
"2018-09-24 16:00:02",443643061,"Loan 5569367-01 - investment in loan  ",-10,9.9595859301858,EUR
"2018-09-24 23:30:00",443756543,"Loan 5502710-01 - interest received",0.0092499999999987,9.9688359301858,EUR
"2018-09-24 23:30:00",443756582,"Loan 5502710-01 - principal received",1.7792610250298,11.748096955216,EUR
"2018-09-24 23:30:00",443756825,"Loan 5502850-01 - interest received",0.0092499999999987,11.757346955216,EUR
"2018-09-24 23:30:00",443756883,"Loan 5502850-01 - principal received",1.4444897959184,13.201836751134,EUR
"2018-09-24 23:30:00",443811327,"Loan 5503035-01 - interest received",0.012333333333332,13.214170084467,EUR
"2018-09-24 23:30:00",443811348,"Loan 5503035-01 - principal received",1.4444897959184,14.658659880386,EUR
"2018-09-25 02:18:42",443860996,"Loan 5573630-01 - investment in loan  ",-10,4.6586598803857,EUR
"2018-09-25 04:16:26",444359413,"Loan 5502375-01 - The loan was repurchased. Reason: The loan was repaid early by the borrower.: interest received",0.012499999999999,4.6711598803857,EUR
"2018-09-25 04:16:26",444359417,"Loan 5502375-01 - The loan was repurchased. Reason: The loan was repaid early by the borrower.: Principal received",10,14.671159880386,EUR
"2018-09-25 06:05:25",444563788,"Loan 5573620-01 - investment in loan  ",-10,4.6711598803857,EUR
"2018-09-25 23:30:00",444734585,"Loan 5502836-01 - interest received",0.0092499999999987,4.6804098803857,EUR
"2018-09-25 23:30:00",444734666,"Loan 5502836-01 - principal received",1.4446428571429,6.1250527375285,EUR
"2018-09-25 23:30:00",444736489,"Loan 5502592-01 - interest received",0.0092499999999987,6.1343027375285,EUR
"2018-09-25 23:30:00",444736502,"Loan 5502592-01 - principal received",1.4391865467345,7.573489284263,EUR
"2018-09-25 23:30:00",444736544,"Loan 5502682-01 - interest received",0.0092499999999987,7.582739284263,EUR
"2018-09-25 23:30:00",444736606,"Loan 5502682-01 - principal received",1.4409523809524,9.0236916652153,EUR
"2018-09-25 23:30:00",444740916,"Loan 5502633-01 - interest received",0.0092499999999987,9.0329416652153,EUR
"2018-09-25 23:30:00",444740965,"Loan 5502633-01 - principal received",1.4444897959184,10.477431461134,EUR
"2018-09-26 02:30:11",444804553,"Loan 5439443-02 - investment in loan  ",-10,0.47743146113371,EUR
"2018-09-26 04:51:36",445718632,"Loan 5503436-01 - The loan was repurchased. Reason: The loan was repaid early by the borrower.: interest received",0.018499999999997,0.49593146113371,EUR
"2018-09-26 04:51:36",445718642,"Loan 5503436-01 - The loan was repurchased. Reason: The loan was repaid early by the borrower.: Principal received",10,10.495931461134,EUR
"2018-09-26 08:01:20",445910778,"Loan 3007031-07 - investment in loan  ",-10,0.49593146113371,EUR
"2018-09-26 23:30:00",446616061,"Loan 5502678-01 - interest received",0.0092499999999987,0.50518146113371,EUR
"2018-09-26 23:30:00",446616083,"Loan 5502678-01 - principal received",1.4443544930711,1.9495359542048,EUR
"2018-09-27 23:30:00",447359322,"Loan 5503217-01 - interest received",0.019999999999999,1.9695359542048,EUR
"2018-09-27 23:30:00",447359331,"Loan 5503217-01 - principal received",10,11.969535954205,EUR
"2018-09-28 03:12:18",447444103,"Loan 5632365-14 - investment in loan  ",-10,1.9695359542048,EUR
"2018-09-28 04:53:16",448139298,"Loan 5503188-01 - The loan was repurchased. Reason: The loan was repaid early by the borrower.: interest received",0.024444444444439,1.9939803986492,EUR
"2018-09-28 04:53:16",448139305,"Loan 5503188-01 - The loan was repurchased. Reason: The loan was repaid early by the borrower.: Principal received",10,11.993980398649,EUR
"2018-09-28 08:10:33",448327674,"Loan 3137132-207 - investment in loan  ",-10,1.9939803986492,EUR
"2018-09-28 23:30:00",449514625,"Loan 5502556-01 - interest received",0.001818402285884,1.9957988009351,EUR
"2018-09-28 23:30:00",449514669,"Loan 5502556-01 - principal received",1.1795041854386,3.1753029863737,EUR
"2018-09-28 23:30:00",449519340,"Loan 5502519-01 - interest received",0.0092499999999987,3.1845529863737,EUR
"2018-09-28 23:30:00",449519359,"Loan 5502519-01 - interest received",0.002227092099111,3.1867800784728,EUR
"2018-09-28 23:30:00",449519378,"Loan 5502519-01 - principal received",1.4446002805049,4.6313803589777,EUR
"2018-10-01 04:12:18",450906001,"Loan 4545328-05 - The loan was repurchased. Reason: The loan term was prolonged.: interest received",0.016666666666661,4.6480470256444,EUR
"2018-10-01 04:12:18",450906008,"Loan 4545328-05 - The loan was repurchased. Reason: The loan term was prolonged.: Principal received",10,14.648047025644,EUR
"2018-10-01 05:37:47",451170183,"Loan 4953491-59 - investment in loan  ",-10,4.6480470256444,EUR
"2018-10-01 23:30:00",452375630,"Loan 5503179-01 - interest received",0.036999999999995,4.6850470256444,EUR
"2018-10-01 23:30:00",452375800,"Loan 5503179-01 - principal received",1.4391249336762,6.1241719593205,EUR
"2018-10-01 23:30:00",452423558,"Loan 5503354-01 - interest received",0.036999999999995,6.1611719593205,EUR
"2018-10-01 23:30:00",452423591,"Loan 5503354-01 - principal received",1.4446428571429,7.6058148164634,EUR
"2018-10-01 23:30:00",452424152,"Loan 5503340-01 - interest received",0.036999999999995,7.6428148164634,EUR
"2018-10-01 23:30:00",452424174,"Loan 5503340-01 - principal received",1.4443544930711,9.0871693095345,EUR
"2018-10-01 23:30:00",452433861,"Loan 5503263-01 - interest received",0.036999999999995,9.1241693095345,EUR
"2018-10-01 23:30:00",452433891,"Loan 5503263-01 - principal received",1.4421180532406,10.566287362775,EUR
"2018-10-01 23:30:00",452436744,"Loan 5503491-01 - interest received",0.036999999999995,10.603287362775,EUR
"2018-10-01 23:30:00",452436796,"Loan 5503491-01 - principal received",1.4446428571429,12.047930219918,EUR
"2018-10-01 23:30:00",452446239,"Loan 5503427-01 - interest received",0.036999999999995,12.084930219918,EUR
"2018-10-01 23:30:00",452446273,"Loan 5503427-01 - principal received",1.4444897959184,13.529420015836,EUR
"2018-10-01 23:30:00",452917930,"Loan 5503129-01 - interest received",0.036999999999995,13.566420015836,EUR
"2018-10-01 23:30:00",452917945,"Loan 5503129-01 - principal received",1.4443544930711,15.010774508907,EUR
"2018-10-01 23:30:00",452939019,"Loan 5503241-01 - interest received",0.036999999999995,15.047774508907,EUR
"2018-10-01 23:30:00",452939050,"Loan 5503241-01 - principal received",1.4443544930711,16.492129001979,EUR
"2018-10-01 23:30:00",452939973,"Loan 5503482-01 - interest received",0.036999999999995,16.529129001978,EUR
"2018-10-01 23:30:00",452939998,"Loan 5503482-01 - principal received",1.4444894169186,17.973618418897,EUR
"2018-10-01 23:30:00",452940271,"Loan 5503023-01 - interest received",0.036999999999995,18.010618418897,EUR
"2018-10-01 23:30:00",452940328,"Loan 5503023-01 - principal received",0.12990602542841,18.140524444326,EUR
"2018-10-01 23:30:00",452948252,"Loan 5503322-01 - interest received",0.036999999999995,18.177524444326,EUR
"2018-10-01 23:30:00",452948267,"Loan 5503322-01 - principal received",0.60959493417096,18.787119378497,EUR
"2018-10-02 09:08:59",453418703,"Loan 3844562-04 - investment in loan  ",-10,8.7871193784965,EUR
"2018-10-02 23:30:00",453658240,"Loan 5503160-01 - interest received",0.036999999999995,8.8241193784965,EUR
"2018-10-02 23:30:00",453658307,"Loan 5503160-01 - principal received",1.4443544930711,10.268473871568,EUR
"2018-10-03 02:28:39",453736763,"Loan 4953784-179 - investment in loan  ",-10,0.2684738715676,EUR
"2018-10-03 05:23:02",454498359,"Loan 5569367-01 - The loan was repurchased. Reason: The loan term was prolonged.: interest received",0.021111111111103,0.2895849826787,EUR
"2018-10-03 05:23:02",454498361,"Loan 5569367-01 - The loan was repurchased. Reason: The loan term was prolonged.: Principal received",10,10.289584982679,EUR
"2018-10-03 08:01:42",454589263,"Loan 4953396-84 - investment in loan  ",-10,0.2895849826787,EUR
"2018-10-03 23:30:00",454747289,"Loan 5503263-01 - principal received",0.0022364398304637,0.29182142250916,EUR
"2018-10-04 04:27:11",455384131,"Loan 5502394-01 - The loan was repurchased. Reason: The loan was repaid early by the borrower.: interest received",0.034999999999999,0.32682142250916,EUR
"2018-10-04 04:27:11",455384141,"Loan 5502394-01 - The loan was repurchased. Reason: The loan was repaid early by the borrower.: Principal received",10,10.326821422509,EUR
"2018-10-04 06:22:06",455622155,"Loan 4223846-01 - investment in loan  ",-10,0.32682142250916,EUR
"2018-10-05 04:39:02",456393752,"Loan 5503211-01 - The loan was repurchased. Reason: The loan was repaid early by the borrower.: interest received",0.037499999999998,0.36432142250916,EUR
"2018-10-05 04:39:02",456393763,"Loan 5503211-01 - The loan was repurchased. Reason: The loan was repaid early by the borrower.: Principal received",10,10.364321422509,EUR
"2018-10-05 06:53:33",456612582,"Loan 4666186-03 - investment in loan  ",-10,0.36432142250916,EUR
"2018-10-09 04:22:01",459643470,"Loan 5503213-01 - The loan was repurchased. Reason: The loan was repaid early by the borrower.: interest received",0.047499999999998,0.41182142250916,EUR
"2018-10-09 04:22:01",459643474,"Loan 5503213-01 - The loan was repurchased. Reason: The loan was repaid early by the borrower.: Principal received",10,10.411821422509,EUR
"2018-10-09 06:34:15",459873877,"Loan 4314348-06 - investment in loan  ",-10,0.41182142250916,EUR
"2018-10-09 23:30:00",460417200,"Loan 5503322-01 - interest received",0.0018021399613483,0.41362356247051,EUR
"2018-10-09 23:30:00",460417225,"Loan 5503322-01 - principal received",0.83496832186058,1.2485918843311,EUR
"2018-10-11 04:40:15",461957926,"Loan 5503218-01 - The loan was repurchased. Reason: The loan was repaid early by the borrower.: interest received",0.052499999999998,1.3010918843311,EUR
"2018-10-11 04:40:15",461957933,"Loan 5503218-01 - The loan was repurchased. Reason: The loan was repaid early by the borrower.: Principal received",10,11.301091884331,EUR
"2018-10-11 10:38:34",462345663,"Loan 2891237-22 - investment in loan  ",-10,1.3010918843311,EUR
"2018-10-12 04:46:51",463184262,"Loan 5503111-01 - The loan was repurchased. Reason: The loan was repaid early by the borrower.: interest received",0.067222222222208,1.3683141065533,EUR
"2018-10-12 04:46:51",463184271,"Loan 5503111-01 - The loan was repurchased. Reason: The loan was repaid early by the borrower.: Principal received",10,11.368314106553,EUR
"2018-10-12 05:02:26",463224439,"Loan 5503220-01 - The loan was repurchased. Reason: The loan term was prolonged.: interest received",0.029999999999999,11.398314106553,EUR
"2018-10-12 05:02:26",463224446,"Loan 5503220-01 - The loan was repurchased. Reason: The loan term was prolonged.: late payment interest received",0.024999999999999,11.423314106553,EUR
"2018-10-12 05:02:26",463224453,"Loan 5503220-01 - The loan was repurchased. Reason: The loan term was prolonged.: Principal received",10,21.423314106553,EUR
"2018-10-12 06:05:28",463378865,"Loan 4546497-03 - The loan was repurchased. Reason: The loan term was prolonged.: interest received",0.047222222222207,21.470536328775,EUR
"2018-10-12 06:05:28",463378874,"Loan 4546497-03 - The loan was repurchased. Reason: The loan term was prolonged.: Principal received",10,31.470536328775,EUR
"2018-10-12 07:05:39",463410350,"Loan 5361095-04 - investment in loan  ",-10,21.470536328775,EUR
"2018-10-12 07:05:40",463410356,"Loan 5325576-04 - investment in loan  ",-10,11.470536328776,EUR
"2018-10-12 07:05:41",463410361,"Loan 4553441-04 - investment in loan  ",-10,1.4705363287755,EUR
"2018-10-13 05:12:11",464358763,"Loan 5502385-01 - The loan was repurchased. Reason: The loan was repaid early by the borrower.: interest received",0.057499999999998,1.5280363287755,EUR
"2018-10-13 05:12:11",464358768,"Loan 5502385-01 - The loan was repurchased. Reason: The loan was repaid early by the borrower.: Principal received",10,11.528036328775,EUR
"2018-10-13 05:27:13",464406393,"Loan 4543077-04 - The loan was repurchased. Reason: The loan term was prolonged.: interest received",0.049999999999984,11.578036328775,EUR
"2018-10-13 05:27:13",464406403,"Loan 4543077-04 - The loan was repurchased. Reason: The loan term was prolonged.: Principal received",10,21.578036328775,EUR
"2018-10-13 08:19:41",464530386,"Loan 5772851-01 - investment in loan  ",-10,11.578036328775,EUR
"2018-10-13 08:19:42",464530390,"Loan 5870004-01 - investment in loan  ",-10,1.5780363287755,EUR
"2018-10-13 23:30:00",464744979,"Loan 5502382-01 - interest received",0.054999999999998,1.6330363287755,EUR
"2018-10-13 23:30:00",464745042,"Loan 5502382-01 - principal received",0.81033333333333,2.4433696621088,EUR
"2018-10-15 04:09:12",465553473,"Loan 4553441-04 - The loan was repurchased. Reason: The loan agreement was amended.: interest received",0.0061111111111098,2.4494807732199,EUR
"2018-10-15 04:09:12",465553476,"Loan 4553441-04 - The loan was repurchased. Reason: The loan agreement was amended.: Principal received",10,12.44948077322,EUR
"2018-10-15 05:00:35",465682629,"Loan 5959887-01 - investment in loan  ",-10,2.4494807732199,EUR
"2018-10-17 04:25:36",468360349,"Loan 5502382-01 - The loan was repurchased. Reason: The loan term was prolonged.: late payment interest received",0.011487083333333,2.4609678565533,EUR
"2018-10-17 04:25:36",468360365,"Loan 5502382-01 - The loan was repurchased. Reason: The loan term was prolonged.: Principal received",9.1896666666667,11.65063452322,EUR
"2018-10-17 07:05:14",468636780,"Loan 5792519-02 - investment in loan  ",-10,1.6506345232199,EUR
"2018-10-18 04:42:53",469533239,"Loan 5959887-01 - other: interest received",0.0061111111111098,1.656745634331,EUR
"2018-10-18 04:42:53",469533243,"Loan 5959887-01 - other: Principal received",10,11.656745634331,EUR
"2018-10-18 04:59:24",469588795,"Loan 5503223-01 - The loan was repurchased. Reason: The loan term was prolonged.: interest received",0.069999999999997,11.726745634331,EUR
"2018-10-18 04:59:24",469588803,"Loan 5503223-01 - The loan was repurchased. Reason: The loan term was prolonged.: Principal received",10,21.726745634331,EUR
"2018-10-18 06:15:43",469834996,"Loan 4666186-03 - The loan was repurchased. Reason: The loan term was prolonged.: interest received",0.036666666666659,21.763412300998,EUR
"2018-10-18 06:15:43",469835007,"Loan 4666186-03 - The loan was repurchased. Reason: The loan term was prolonged.: Principal received",10,31.763412300998,EUR
"2018-10-18 07:55:07",469890673,"Loan 5019788-04 - investment in loan  ",-10,21.763412300998,EUR
"2018-10-18 07:55:08",469890680,"Loan 5103925-06 - investment in loan  ",-10,11.763412300998,EUR
"2018-10-18 07:55:09",469890685,"Loan 6023220-01 - investment in loan  ",-10,1.7634123009977,EUR
"2018-10-19 05:25:04",470889239,"Loan 3844562-04 - The loan was repurchased. Reason: The loan term was prolonged.: interest received",0.039722222222214,1.8031345232199,EUR
"2018-10-19 05:25:04",470889248,"Loan 3844562-04 - The loan was repurchased. Reason: The loan term was prolonged.: Principal received",10,11.80313452322,EUR
"2018-10-19 05:43:58",470949182,"Loan 5503479-01 - The loan was repurchased. Reason: The loan term was prolonged.: interest received",0.084583333333311,11.887717856553,EUR
"2018-10-19 05:43:58",470949195,"Loan 5503479-01 - The loan was repurchased. Reason: The loan term was prolonged.: Principal received",10,21.887717856553,EUR
"2018-10-19 08:25:31",471026769,"Loan 3014995-07 - investment in loan  ",-10,11.887717856553,EUR
"2018-10-19 08:25:33",471026775,"Loan 6044658-01 - investment in loan  ",-10,1.8877178565532,EUR
"2018-10-21 04:21:11",473241408,"Loan 5019788-04 - The loan was repurchased. Reason: The loan agreement was amended.: interest received",0.0066666666666658,1.8943845232199,EUR
"2018-10-21 04:21:11",473241411,"Loan 5019788-04 - The loan was repurchased. Reason: The loan agreement was amended.: Principal received",10,11.89438452322,EUR
"2018-10-21 06:22:24",473416926,"Loan 6077533-01 - investment in loan  ",-10,1.8943845232199,EUR
"2018-10-22 23:30:00",474440152,"Loan 5502760-01 - interest received",0.076023717328161,1.970408240548,EUR
"2018-10-22 23:30:00",474440233,"Loan 5502760-01 - principal received",1.8843675935508,3.8547758340988,EUR
"2018-10-22 23:30:00",474450840,"Loan 5502682-01 - interest received",0.079171190476179,3.933947024575,EUR
"2018-10-22 23:30:00",474450865,"Loan 5502682-01 - principal received",0.050952380952383,3.9848994055274,EUR
"2018-10-22 23:30:00",474464201,"Loan 5502562-01 - interest received",0.091210677293892,4.0761100828212,EUR
"2018-10-22 23:30:00",474464233,"Loan 5502562-01 - principal received",0.14747218050903,4.2235822633303,EUR
"2018-10-22 23:30:00",474465139,"Loan 5502836-01 - interest received",0.079137053571417,4.3027193169017,EUR
"2018-10-22 23:30:00",474465177,"Loan 5502836-01 - principal received",0.60554151785715,4.9082608347588,EUR
"2018-10-22 23:30:00",474470490,"Loan 5502556-01 - interest received",0.076041492852762,4.9843023276116,EUR
"2018-10-22 23:30:00",474470498,"Loan 5502556-01 - principal received",0.59702159159588,5.5813239192075,EUR
"2018-10-22 23:30:00",474478239,"Loan 5502633-01 - interest received",0.079138469387745,5.6604623885952,EUR
"2018-10-22 23:30:00",474478254,"Loan 5502633-01 - principal received",0.045897244897969,5.7063596334932,EUR
"2018-10-22 23:30:00",474478469,"Loan 5502764-01 - interest received",0.079139720939082,5.7854993544323,EUR
"2018-10-22 23:30:00",474478503,"Loan 5502764-01 - principal received",1.5267393685414,7.3122387229736,EUR
"2018-10-22 23:30:00",474478872,"Loan 5502615-01 - interest received",0.079190571428562,7.3914292944022,EUR
"2018-10-22 23:30:00",474478890,"Loan 5502615-01 - principal received",1.5234285714286,8.9148578658308,EUR
"2018-10-22 23:30:00",474491972,"Loan 5502678-01 - interest received",0.079139720939082,8.9939975867699,EUR
"2018-10-22 23:30:00",474491986,"Loan 5502678-01 - principal received",0.085718367541313,9.0797159543112,EUR
"2018-10-22 23:30:00",474493433,"Loan 5502592-01 - interest received",0.079187524442697,9.1589034787539,EUR
"2018-10-22 23:30:00",474493466,"Loan 5502592-01 - principal received",0.048441630817376,9.2073451095712,EUR
"2018-10-22 23:30:00",474505355,"Loan 5502850-01 - interest received",0.000545918367349,9.2078910279386,EUR
"2018-10-22 23:30:00",474505516,"Loan 5502710-01 - interest received",0.076041835518465,9.2839328634571,EUR
"2018-10-22 23:30:00",474505565,"Loan 5502710-01 - principal received",1.1928486293206,10.476781492778,EUR
"2018-10-22 23:30:00",474506567,"Loan 5502519-01 - interest received",0.079137447405318,10.555918940183,EUR
"2018-10-22 23:30:00",474506596,"Loan 5502519-01 - principal received",1.5266739390162,12.082592879199,EUR
"2018-10-22 23:30:00",474523046,"Loan 5502756-01 - interest received",0.091212810291708,12.173805689491,EUR
"2018-10-22 23:30:00",474523101,"Loan 5502756-01 - principal received",0.14749048740714,12.321296176898,EUR
"2018-10-22 23:30:00",474534610,"Loan 5502801-01 - interest received",0.0039642857142872,12.325260462612,EUR
"2018-10-23 03:18:49",474574510,"Loan 6144022-01 - investment in loan  ",-10,2.3252604626123,EUR
"2018-10-23 04:10:48",474899253,"Loan 5103925-06 - The loan was repurchased. Reason: The loan agreement was amended.: interest received",0.013333333333332,2.3385937959456,EUR
"2018-10-23 04:10:48",474899257,"Loan 5103925-06 - The loan was repurchased. Reason: The loan agreement was amended.: Principal received",10,12.338593795946,EUR
"2018-10-23 04:35:59",474982722,"Loan 4314348-06 - The loan was repurchased. Reason: The loan term was prolonged.: interest received",0.039722222222214,12.378316018168,EUR
"2018-10-23 04:35:59",474982728,"Loan 4314348-06 - The loan was repurchased. Reason: The loan term was prolonged.: Principal received",10,22.378316018168,EUR
"2018-10-23 05:21:18",475120854,"Loan 5361095-04 - The loan was repurchased. Reason: The loan term was prolonged.: interest received",0.018333333333329,22.396649351501,EUR
"2018-10-23 05:21:18",475120860,"Loan 5361095-04 - The loan was repurchased. Reason: The loan term was prolonged.: late payment interest received",0.0091666666666647,22.405816018168,EUR
"2018-10-23 05:21:18",475120867,"Loan 5361095-04 - The loan was repurchased. Reason: The loan term was prolonged.: Principal received",10,32.405816018168,EUR
"2018-10-23 05:21:48",475122444,"Loan 5325576-04 - The loan was repurchased. Reason: The loan term was prolonged.: interest received",0.018333333333329,32.424149351501,EUR
"2018-10-23 05:21:48",475122447,"Loan 5325576-04 - The loan was repurchased. Reason: The loan term was prolonged.: late payment interest received",0.0091666666666647,32.433316018168,EUR
"2018-10-23 05:21:48",475122450,"Loan 5325576-04 - The loan was repurchased. Reason: The loan term was prolonged.: Principal received",10,42.433316018168,EUR
"2018-10-23 06:39:24",475205636,"Loan 5189119-04 - investment in loan  ",-10,32.433316018168,EUR
"2018-10-23 06:39:25",475205651,"Loan 4006616-05 - investment in loan  ",-10,22.433316018168,EUR
"2018-10-23 06:39:26",475205657,"Loan 4648781-06 - investment in loan  ",-10,12.433316018168,EUR
"2018-10-23 06:39:28",475205664,"Loan 5633753-03 - investment in loan  ",-10,2.4333160181678,EUR
"2018-10-23 23:30:00",475554372,"Loan 5503033-01 - interest received",0.079139720939082,2.5124557391069,EUR
"2018-10-23 23:30:00",475554402,"Loan 5503033-01 - principal received",1.5267393685414,4.0391951076483,EUR
"2018-10-23 23:30:00",475636676,"Loan 5502710-01 - principal received",0.69034564958284,4.7295407572311,EUR
"2018-10-23 23:30:00",475641262,"Loan 5502801-01 - interest received",0.075172767857,4.8047135250881,EUR
"2018-10-23 23:30:00",475641292,"Loan 5502801-01 - principal received",1.5267857142857,6.3314992393738,EUR
"2018-10-23 23:30:00",475666248,"Loan 5503035-01 - interest received",0.010204081632654,6.3417033210065,EUR
"2018-10-23 23:30:00",475747409,"Loan 5502487-01 - interest received",0.079137714285705,6.4208410352922,EUR
"2018-10-23 23:30:00",475747432,"Loan 5502487-01 - principal received",1.5268571428571,7.9476981781493,EUR
"2018-10-23 23:30:00",476019091,"Loan 5439443-02 - interest received",0.060694444444422,8.0083926225937,EUR
"2018-10-23 23:30:00",476019103,"Loan 5439443-02 - interest received",0.0013884553367496,8.0097810779305,EUR
"2018-10-23 23:30:00",476019117,"Loan 5439443-02 - principal received",1.315378740079,9.3251598180095,EUR
"2018-10-23 23:30:00",476019567,"Loan 5573630-01 - interest received",0.058055555555534,9.383215373565,EUR
"2018-10-23 23:30:00",476019585,"Loan 5573630-01 - interest received",0.0020829306595788,9.3852983042246,EUR
"2018-10-23 23:30:00",476019623,"Loan 5573630-01 - principal received",1.3152642546509,10.700562558876,EUR
"2018-10-23 23:30:00",476022892,"Loan 5573620-01 - interest received",0.0030026423252461,10.703565201201,EUR
"2018-10-24 05:03:16",476292563,"Loan 6162909-01 - investment in loan  ",-10,0.70356520120075,EUR
"2018-10-24 05:08:04",476307211,"Loan 5502850-01 - The loan was repurchased. Reason: The loan was repaid early by the borrower.: interest received",0.080759693877143,0.78432489507789,EUR
"2018-10-24 05:08:04",476307225,"Loan 5502850-01 - The loan was repurchased. Reason: The loan was repaid early by the borrower.: Principal received",8.5555102040816,9.3398350991595,EUR
"2018-10-24 12:31:03",476575004,Deposits,50,59.33983509916,EUR
"2018-10-24 12:32:10",476575366,"Loan 6179055-01 - investment in loan  ",-10,49.33983509916,EUR
"2018-10-24 12:32:11",476575372,"Loan 6177793-01 - investment in loan  ",-10,39.33983509916,EUR
"2018-10-24 12:32:12",476575378,"Loan 6179068-01 - investment in loan  ",-10,29.33983509916,EUR
"2018-10-24 12:32:13",476575384,"Loan 6177498-01 - investment in loan  ",-10,19.33983509916,EUR
"2018-10-24 12:32:14",476575443,"Loan 6176469-01 - investment in loan  ",-10,9.3398350991595,EUR
"2018-10-24 23:30:00",476871713,"Loan 5502678-01 - principal received",1.441021001,10.78085610016,EUR
"2018-10-25 03:22:47",477002983,"Loan 6084789-01 - investment in loan  ",-10,0.78085610015957,EUR
"2018-10-25 23:30:00",478089422,"Loan 5502592-01 - principal received",1.4748278255768,2.2556839257364,EUR
"2018-10-25 23:30:00",478104450,"Loan 5502633-01 - principal received",1.4810415306122,3.7367254563486,EUR
"2018-10-25 23:30:00",478349965,"Loan 4714107-02 - interest received",0.10999999999998,3.8467254563486,EUR
"2018-10-25 23:30:00",478350199,"Loan 4714107-02 - principal received",9.9999999999999,13.846725456349,EUR
"2018-10-26 06:35:11",478872436,"Loan 6196941-01 - investment in loan  ",-10,3.8467254563485,EUR
"2018-10-26 23:30:00",479341018,"Loan 5502836-01 - principal received",0.92124419642856,4.7679696527771,EUR
"2018-10-26 23:30:00",479702795,"Loan 5573620-01 - interest received",0.05505291323,4.8230225660071,EUR
"2018-10-26 23:30:00",479702805,"Loan 5573620-01 - interest received",0.0033417157098231,4.8263642817169,EUR
"2018-10-26 23:30:00",479702811,"Loan 5573620-01 - principal received",1.4070381936104,6.2334024753273,EUR
"2018-10-27 05:38:09",480092317,"Loan 3007031-07 - The loan was repurchased. Reason: The loan term was prolonged.: interest received",0.088611111111092,6.3220135864384,EUR
"2018-10-27 05:38:09",480092327,"Loan 3007031-07 - The loan was repurchased. Reason: The loan term was prolonged.: Principal received",10,16.322013586438,EUR
"2018-10-27 06:09:21",480189728,"Loan 5336177-02 - investment in loan  ",-10,6.3220135864384,EUR
"2018-10-29 04:38:59",481861190,"Loan 2891237-22 - The loan was repurchased. Reason: The loan was repaid early by the borrower.: interest received",0.054305555555546,6.3763191419939,EUR
"2018-10-29 04:38:59",481861205,"Loan 2891237-22 - The loan was repurchased. Reason: The loan was repaid early by the borrower.: Principal received",10,16.376319141994,EUR
"2018-10-29 06:16:36",481928609,"Loan 6237500-02 - investment in loan  ",-10,6.3763191419939,EUR
"2018-10-30 23:30:00",483474799,"Loan 5502556-01 - interest received",0.0027762354878909,6.3790953774818,EUR
"2018-10-30 23:30:00",483474817,"Loan 5502556-01 - principal received",1.2862867125367,7.6653820900185,EUR
"2018-10-30 23:30:00",483496458,"Loan 5502682-01 - interest received",0.0031799444444439,7.668562034463,EUR
"2018-10-30 23:30:00",483496480,"Loan 5502682-01 - principal received",1.4733333333333,9.1418953677963,EUR
"2018-10-31 23:30:00",484791085,"Loan 5772851-01 - interest received",0.052499999999965,9.1943953677963,EUR
"2018-10-31 23:30:00",484797083,"Loan 5772851-01 - principal received",9.9999999999957,19.194395367792,EUR
"2018-11-01 02:45:04",484890775,"Loan 6335422-01 - investment in loan  ",-10,9.194395367792,EUR
"2018-11-01 04:54:56",485897377,"Loan 5503482-01 - The loan was repurchased. Reason: The loan was repaid early by the borrower.: interest received",0.079138472893491,9.2735338406855,EUR
"2018-11-01 04:54:56",485897395,"Loan 5503482-01 - The loan was repurchased. Reason: The loan was repaid early by the borrower.: Principal received",8.5555105830814,17.829044423767,EUR
"2018-11-01 08:15:55",486383525,"Loan 6327483-01 - investment in loan  ",-10,7.8290444237668,EUR
"2018-11-01 23:30:00",486773632,"Loan 5502390-01 - interest received",0.074999999999997,7.9040444237668,EUR
"2018-11-01 23:30:00",486773665,"Loan 5502390-01 - interest received",0.029999999999999,7.9340444237668,EUR
"2018-11-01 23:30:00",486773693,"Loan 5502390-01 - principal received",3.3291666666667,11.263211090433,EUR
"2018-11-01 23:30:00",486788698,"Loan 5503340-01 - interest received",0.081777711637051,11.344988802071,EUR
"2018-11-01 23:30:00",486788711,"Loan 5503340-01 - principal received",1.5267393685414,12.871728170612,EUR
"2018-11-01 23:30:00",486798774,"Loan 5503241-01 - interest received",0.081777711637051,12.953505882249,EUR
"2018-11-01 23:30:00",486798808,"Loan 5503241-01 - principal received",1.5265387320031,14.480044614252,EUR
"2018-11-01 23:30:00",486798908,"Loan 5503427-01 - interest received",0.081776418367336,14.561821032619,EUR
"2018-11-01 23:30:00",486798949,"Loan 5503427-01 - principal received",1.5269387755102,16.08875980813,EUR
"2018-11-01 23:30:00",486808495,"Loan 5503263-01 - interest received",0.081777711637051,16.170537519767,EUR
"2018-11-01 23:30:00",486808536,"Loan 5503263-01 - principal received",1.5267393685414,17.697276888308,EUR
"2018-11-01 23:30:00",486822165,"Loan 5503023-01 - interest received",0.094341648240268,17.791618536548,EUR
"2018-11-01 23:30:00",486822196,"Loan 5503023-01 - principal received",0.13764510779436,17.929263644343,EUR
"2018-11-01 23:30:00",486826745,"Loan 5503160-01 - interest received",0.048242154388308,17.977505798731,EUR
"2018-11-01 23:30:00",486835242,"Loan 5503129-01 - interest received",0.081777711637051,18.059283510368,EUR
"2018-11-01 23:30:00",486835272,"Loan 5503129-01 - principal received",1.5267393685414,19.586022878909,EUR
"2018-11-01 23:30:00",486892873,"Loan 5503322-01 - interest received",0.081775716211087,19.66779859512,EUR
"2018-11-01 23:30:00",486892950,"Loan 5503322-01 - principal received",1.5267660228564,21.194564617977,EUR
"2018-11-01 23:30:00",486968823,"Loan 5503354-01 - interest received",0.081774955357131,21.276339573334,EUR
"2018-11-01 23:30:00",486968940,"Loan 5503354-01 - principal received",1.5267857142857,22.80312528762,EUR
"2018-11-01 23:30:00",486979879,"Loan 5503491-01 - interest received",0.081774955357131,22.884900242977,EUR
"2018-11-01 23:30:00",486979912,"Loan 5503491-01 - principal received",1.5267857142857,24.411685957263,EUR
"2018-11-01 23:30:00",486982306,"Loan 5503179-01 - interest received",0.081827697508934,24.493513654771,EUR
"2018-11-01 23:30:00",486982319,"Loan 5503179-01 - principal received",1.5232031345659,26.016716789337,EUR
"2018-11-01 23:30:00",487181129,"Loan 3014995-07 - interest received",0.039722222222214,26.05643901156,EUR
"2018-11-01 23:30:00",487181229,"Loan 3014995-07 - principal received",10,36.05643901156,EUR
"2018-11-02 03:38:55",486917232,"Loan 6358966-01 - investment in loan  ",-10,26.05643901156,EUR
"2018-11-02 03:38:56",486917322,"Loan 6359943-01 - investment in loan  ",-10,16.05643901156,EUR
"2018-11-02 06:15:28",487906987,"Loan 2448784-03 - investment in loan  ",-10,6.0564390115596,EUR
"2018-11-02 23:30:00",488340748,"Loan 5502390-01 - interest received",0.001667708333,6.0581067198926,EUR
"2018-11-02 23:30:00",488340772,"Loan 5502390-01 - principal received",1.6252689583335,7.6833756782261,EUR
"2018-11-02 23:30:00",488724261,"Loan 5792519-02 - interest received",0.046666666666661,7.7300423448927,EUR
"2018-11-02 23:30:00",488724264,"Loan 5792519-02 - principal received",10,17.730042344893,EUR
"2018-11-03 04:21:30",488835566,"Loan 5189119-04 - The loan was repurchased. Reason: The loan term was prolonged.: interest received",0.019999999999997,17.750042344893,EUR
"2018-11-03 04:21:30",488835571,"Loan 5189119-04 - The loan was repurchased. Reason: The loan term was prolonged.: Principal received",10,27.750042344893,EUR
"2018-11-03 04:31:54",488869406,"Loan 6375173-01 - investment in loan  ",-10,17.750042344893,EUR
"2018-11-03 04:31:55",488869461,"Loan 6383011-01 - investment in loan  ",-10,7.7500423448927,EUR
"2018-11-06 05:40:53",490884367,"Loan 5503160-01 - The loan was repurchased. Reason: The loan was repaid early by the borrower.: interest received",0.042204541485344,7.7922468863781,EUR
"2018-11-06 05:40:53",490884381,"Loan 5503160-01 - The loan was repurchased. Reason: The loan was repaid early by the borrower.: Principal received",8.5556455069289,16.347892393307,EUR
"2018-11-06 10:09:11",491901121,"Loan 2842480-10 - investment in loan  ",-10,6.347892393307,EUR
"2018-11-07 23:30:00",493689443,"Loan 5502380-01 - interest received",0.074999999999997,6.422892393307,EUR
"2018-11-07 23:30:00",493689607,"Loan 5502380-01 - interest received",0.044999999999998,6.467892393307,EUR
"2018-11-07 23:30:00",493689695,"Loan 5502380-01 - principal received",10,16.467892393307,EUR
"2018-11-08 08:57:32",494320579,"Loan 5875389-05 - investment in loan  ",-10,6.467892393307,EUR
"2018-11-09 05:11:06",494735324,"Loan 6162909-01 - The loan was repurchased. Reason: The loan agreement was terminated.: interest received",0.04444444444443,6.5123368377514,EUR
"2018-11-09 05:11:06",494735348,"Loan 6162909-01 - The loan was repurchased. Reason: The loan agreement was terminated.: Principal received",10,16.512336837751,EUR
"2018-11-09 07:17:22",495394777,"Loan 5336177-02 - The loan was repurchased. Reason: The loan term was prolonged.: interest received",0.039999999999995,16.552336837751,EUR
"2018-11-09 07:17:22",495394785,"Loan 5336177-02 - The loan was repurchased. Reason: The loan term was prolonged.: Principal received",10,26.552336837751,EUR
"2018-11-09 08:06:29",495416866,"Loan 4577293-07 - investment in loan  ",-10,16.552336837751,EUR
"2018-11-09 08:06:30",495416873,"Loan 4807146-07 - investment in loan  ",-10,6.5523368377514,EUR
"2018-11-11 04:30:39",496758815,"Loan 5502756-01 - The loan was repurchased. Reason: The loan was repaid early by the borrower.: interest received",0.053909113969915,6.6062459517213,EUR
"2018-11-11 04:30:39",496758828,"Loan 5502756-01 - The loan was repurchased. Reason: The loan was repaid early by the borrower.: Principal received",9.7133538684544,16.319599820176,EUR
"2018-11-11 05:33:07",496938910,"Loan 4577293-07 - The loan was repurchased. Reason: The loan agreement was amended.: interest received",0.0029166666666659,16.322516486842,EUR
"2018-11-11 05:33:07",496938913,"Loan 4577293-07 - The loan was repurchased. Reason: The loan agreement was amended.: Principal received",10,26.322516486842,EUR
"2018-11-11 06:15:37",497176089,"Loan 4028819-04 - investment in loan  ",-10,16.322516486842,EUR
"2018-11-11 06:15:38",497176184,"Loan 6558927-01 - investment in loan  ",-10,6.3225164868424,EUR
"2018-11-13 05:03:15",499591732,"Loan 6084789-01 - The loan was repurchased. Reason: The loan agreement was amended.: interest received",0.059999999999992,6.3825164868424,EUR
"2018-11-13 05:03:15",499591737,"Loan 6084789-01 - The loan was repurchased. Reason: The loan agreement was amended.: Principal received",10,16.382516486842,EUR
"2018-11-13 05:27:38",499777120,"Loan 2842480-10 - The loan was repurchased. Reason: The loan term was prolonged.: interest received",0.017499999999995,16.400016486842,EUR
"2018-11-13 05:27:38",499777138,"Loan 2842480-10 - The loan was repurchased. Reason: The loan term was prolonged.: Principal received",10,26.400016486842,EUR
"2018-11-13 08:48:33",500013281,"Loan 4814317-17 - investment in loan  ",-10,16.400016486842,EUR
"2018-11-13 08:48:34",500013286,"Loan 6529344-01 - investment in loan  ",-10,6.4000164868424,EUR
"2018-11-14 23:30:00",501565863,"Loan 5870004-01 - interest received",0.08166666666664,6.481683153509,EUR
"2018-11-14 23:30:00",501568301,"Loan 5870004-01 - principal received",9.999999999999,16.481683153508,EUR
"2018-11-15 02:11:16",501615402,"Loan 6291920-02 - investment in loan  ",-10,6.481683153508,EUR
"2018-11-15 06:51:00",502639108,"Loan 5875389-05 - The loan was repurchased. Reason: The loan term was prolonged.: interest received",0.017499999999995,6.499183153508,EUR
"2018-11-15 06:51:00",502639113,"Loan 5875389-05 - The loan was repurchased. Reason: The loan term was prolonged.: Principal received",10,16.499183153508,EUR
"2018-11-15 11:01:09",502829429,"Loan 6655230-01 - investment in loan  ",-10,6.499183153508,EUR
"2018-11-16 23:30:00",505652445,"Loan 5573620-01 - interest received",0.0028592744950772,6.5020424280031,EUR
"2018-11-18 05:26:46",506096658,"Loan 4648781-06 - The loan was repurchased. Reason: The loan term was prolonged.: interest received",0.019999999999997,6.5220424280031,EUR
"2018-11-18 05:26:46",506096662,"Loan 4648781-06 - The loan was repurchased. Reason: The loan term was prolonged.: Principal received",10,16.522042428003,EUR
"2018-11-18 08:34:08",506567939,"Loan 5610965-03 - investment in loan  ",-10,6.5220424280031,EUR
"2018-11-18 23:30:00",506799329,"Loan 2448784-03 - interest received",0.051111111111102,6.5731535391142,EUR
"2018-11-18 23:30:00",506799640,"Loan 2448784-03 - principal received",1.7059998520382,8.2791533911523,EUR
"2018-11-19 04:12:49",506958570,"Loan 6237500-02 - The loan was repurchased. Reason: The loan term was prolonged.: interest received",0.061111111111098,8.3402645022634,EUR
"2018-11-19 04:12:49",506958576,"Loan 6237500-02 - The loan was repurchased. Reason: The loan term was prolonged.: Principal received",10,18.340264502263,EUR
"2018-11-19 05:26:26",507114007,"Loan 6748008-01 - investment in loan  ",-10,8.3402645022634,EUR
"2018-11-19 23:30:00",507913236,"Loan 5633753-03 - interest received",0.0093737445877781,8.3496382468512,EUR
"2018-11-19 23:30:00",507914223,"Loan 5573630-01 - interest received",0.071043747147701,8.4206819939989,EUR
"2018-11-19 23:30:00",507914237,"Loan 5573630-01 - principal received",1.4393573326891,9.860039326688,EUR
"2018-11-19 23:30:00",507917306,"Loan 5573620-01 - interest received",0.067435926948,9.927475253636,EUR
"2018-11-19 23:30:00",507917359,"Loan 5573620-01 - principal received",1.6556569781408,11.583132231777,EUR
"2018-11-20 02:52:00",507955281,"Loan 6748137-01 - investment in loan  ",-10,1.5831322317767,EUR
"2018-11-20 05:01:26",508164549,"Loan 5633753-03 - The loan was repurchased. Reason: The loan term was prolonged.: interest received",0.033959588745,1.6170918205217,EUR
"2018-11-20 05:01:26",508164556,"Loan 5633753-03 - The loan was repurchased. Reason: The loan term was prolonged.: Principal received",10,11.617091820522,EUR
"2018-11-20 08:32:23",508407677,"Loan 6747657-01 - investment in loan  ",-10,1.6170918205217,EUR
"2018-11-20 23:30:00",508699436,"Loan 6179055-01 - interest received",0.059222222222199,1.6763140427439,EUR
"2018-11-20 23:30:00",508699581,"Loan 6179055-01 - principal received",2.032,3.7083140427439,EUR
"2018-11-20 23:30:00",509542319,"Loan 6144022-01 - interest received",0.038888888888877,3.7472029316328,EUR
"2018-11-20 23:30:00",509542503,"Loan 6144022-01 - interest received",0.0014149593250975,3.7486178909579,EUR
"2018-11-20 23:30:00",509542570,"Loan 6144022-01 - principal received",0.39183489002712,4.140452780985,EUR
"2018-11-20 23:30:00",509566229,"Loan 5439443-02 - interest received",0.073336801750416,4.2137895827354,EUR
"2018-11-20 23:30:00",509566254,"Loan 5439443-02 - principal received",1.4392455085843,5.6530350913198,EUR
"2018-11-21 23:30:00",510468316,"Loan 6177498-01 - interest received",0.056944444444425,5.7099795357642,EUR
"2018-11-21 23:30:00",510468477,"Loan 6177498-01 - principal received",10,15.709979535764,EUR
"2018-11-21 23:30:00",510654263,"Loan 5502615-01 - interest received",0.06726881904761,15.777248354812,EUR
"2018-11-21 23:30:00",510654293,"Loan 5502615-01 - principal received",1.612,17.389248354812,EUR
"2018-11-21 23:30:00",511224079,"Loan 6144022-01 - interest received",0.040034021291541,17.429282376103,EUR
"2018-11-21 23:30:00",511224165,"Loan 6144022-01 - principal received",0.44245254594757,17.871734922051,EUR
"2018-11-22 02:50:31",510468755,"Loan 6820946-01 - investment in loan  ",-10,7.8717349220509,EUR
"2018-11-22 09:37:42",510989001,"Loan 6176469-01 - The loan was repurchased. Reason: The loan term was prolonged.: interest received",0.063777777777753,7.9355126998287,EUR
"2018-11-22 09:37:42",510989015,"Loan 6176469-01 - The loan was repurchased. Reason: The loan term was prolonged.: Principal received",10,17.935512699829,EUR
"2018-11-22 09:50:37",511112995,"Loan 4814317-17 - The loan was repurchased. Reason: The loan term was prolonged.: interest received",0.021666666666665,17.957179366495,EUR
"2018-11-22 09:50:37",511113008,"Loan 4814317-17 - The loan was repurchased. Reason: The loan term was prolonged.: Principal received",10,27.957179366495,EUR
"2018-11-22 12:35:51",511805771,"Loan 3720940-05 - investment in loan  ",-10,17.957179366495,EUR
"2018-11-22 12:35:52",511805784,"Loan 6829419-01 - investment in loan  ",-10,7.9571793664953,EUR
"2018-11-22 14:04:50",512155619,"Loan 5502816-01 - The loan was repurchased. Reason: The loan was more than 60 days late and the buyback obligation was triggered.: interest received",0.15340769230767,8.110587058803,EUR
"2018-11-22 14:04:50",512155628,"Loan 5502816-01 - The loan was repurchased. Reason: The loan was more than 60 days late and the buyback obligation was triggered.: late payment interest received",0.0408423076923,8.1514293664953,EUR
"2018-11-22 14:04:50",512155637,"Loan 5502816-01 - The loan was repurchased. Reason: The loan was more than 60 days late and the buyback obligation was triggered.: Principal received",10,18.151429366495,EUR
"2018-11-22 19:36:48",512353469,"Loan 6840925-01 - investment in loan  ",-10,8.1514293664953,EUR
"2018-11-22 23:30:00",512418179,"Loan 6077533-01 - interest received",0.078749999999971,8.2301793664953,EUR
"2018-11-22 23:30:00",512420923,"Loan 6077533-01 - principal received",9.9999999999987,18.230179366494,EUR
"2018-11-22 23:30:00",512604664,"Loan 5502390-01 - interest received",0.025227821875,18.255407188369,EUR
"2018-11-22 23:30:00",512604803,"Loan 5502390-01 - principal received",0.29672964479167,18.552136833161,EUR
"2018-11-22 23:30:00",512642096,"Loan 5502836-01 - interest received",0.067181428571421,18.619318261732,EUR
"2018-11-22 23:30:00",512642113,"Loan 5502836-01 - principal received",1.6139285714286,20.233246833161,EUR
"2018-11-22 23:30:00",512652155,"Loan 5502678-01 - interest received",0.067184627839413,20.300431461,EUR
"2018-11-22 23:30:00",512652167,"Loan 5502678-01 - principal received",0.1700080956236,20.470439556624,EUR
"2018-11-22 23:30:00",512659688,"Loan 5502760-01 - interest received",0.0055230914310644,20.475962648055,EUR
"2018-11-22 23:30:00",512663914,"Loan 5502633-01 - interest received",0.067181428571421,20.543144076626,EUR
"2018-11-22 23:30:00",512663940,"Loan 5502633-01 - principal received",1.6138775510204,22.157021627647,EUR
"2018-11-22 23:30:00",512664534,"Loan 5502764-01 - interest received",0.067184627839413,22.224206255486,EUR
"2018-11-22 23:30:00",512664596,"Loan 5502764-01 - principal received",1.6138863755417,23.838092631028,EUR
"2018-11-22 23:30:00",512667532,"Loan 5502682-01 - interest received",0.06724059920634,23.905333230234,EUR
"2018-11-22 23:30:00",512667555,"Loan 5502682-01 - principal received",1.6128571428571,25.518190373091,EUR
"2018-11-22 23:30:00",512678280,"Loan 5502519-01 - interest received",0.067182903918402,25.585373277009,EUR
"2018-11-22 23:30:00",512678340,"Loan 5502519-01 - principal received",1.6139421328762,27.199315409886,EUR
"2018-11-22 23:30:00",512679418,"Loan 5502710-01 - interest received",0.060576364719897,27.259891774606,EUR
"2018-11-22 23:30:00",512679442,"Loan 5502710-01 - principal received",1.9933253873659,29.253217161972,EUR
"2018-11-22 23:30:00",512683217,"Loan 5502562-01 - interest received",0.092841444944992,29.346058606917,EUR
"2018-11-22 23:30:00",512683258,"Loan 5502562-01 - principal received",0.155943167379,29.502001774296,EUR
"2018-11-22 23:30:00",512686405,"Loan 5502556-01 - interest received",0.060574920740855,29.562576695036,EUR
"2018-11-22 23:30:00",512686414,"Loan 5502556-01 - principal received",0.87462376981287,30.437200464849,EUR
"2018-11-22 23:30:00",512696381,"Loan 5502592-01 - interest received",0.067267191370085,30.504467656219,EUR
"2018-11-22 23:30:00",512696411,"Loan 5502592-01 - principal received",0.16596129904839,30.670428955268,EUR
"2018-11-22 23:30:00",512699716,"Loan 5502801-01 - interest received",0.067181428571421,30.737610383839,EUR
"2018-11-22 23:30:00",512699750,"Loan 5502801-01 - principal received",1.6139285714286,32.351538955268,EUR
"2018-11-22 23:30:00",512718535,"Loan 5502487-01 - interest received",0.067181428571421,32.418720383839,EUR
"2018-11-22 23:30:00",512718583,"Loan 5502487-01 - principal received",1.6137142857143,34.032434669553,EUR
"2018-11-23 00:50:44",512485439,"Loan 6120655-02 - investment in loan  ",-10,24.032434669553,EUR
"2018-11-23 01:26:47",512797837,"Loan 6816074-01 - investment in loan  ",-10,14.032434669553,EUR
"2018-11-23 01:26:48",512797886,"Loan 6816066-01 - investment in loan  ",-10,4.0324346695534,EUR
"2018-11-23 04:37:46",513226390,"Loan 5503023-01 - The loan was repurchased. Reason: The loan was repaid early by the borrower.: interest received",0.063017606412375,4.0954522759658,EUR
"2018-11-23 04:37:46",513226395,"Loan 5503023-01 - The loan was repurchased. Reason: The loan was repaid early by the borrower.: Principal received",9.7324488667772,13.827901142743,EUR
"2018-11-23 05:51:01",513471743,"Loan 6662977-01 - investment in loan  ",-10,3.827901142743,EUR
"2018-11-24 04:19:25",514367720,"Loan 6829419-01 - The loan was repurchased. Reason: The loan agreement was amended.: interest received",0.0036111111111109,3.8315122538541,EUR
"2018-11-24 04:19:25",514367738,"Loan 6829419-01 - The loan was repurchased. Reason: The loan agreement was amended.: Principal received",10,13.831512253854,EUR
"2018-11-24 05:38:22",514653943,"Loan 6889395-01 - investment in loan  ",-10,3.8315122538541,EUR
"2018-11-24 23:30:00",514982847,"Loan 6177793-01 - interest received",0.0775,3.9090122538541,EUR
"2018-11-24 23:30:00",514982897,"Loan 6177793-01 - principal received",4.13,8.0390122538541,EUR
"2018-11-24 23:30:00",515001735,"Loan 6358966-01 - interest received",0.067092953664911,8.106105207519,EUR
"2018-11-24 23:30:00",515013935,"Loan 5502556-01 - principal received",1.1188130175502,9.2249182250692,EUR
"2018-11-24 23:30:00",515014685,"Loan 5502678-01 - principal received",1.4438782799181,10.668796504987,EUR
"2018-11-24 23:30:00",515024589,"Loan 5502760-01 - interest received",0.055023336226,10.723819841213,EUR
"2018-11-24 23:30:00",515024630,"Loan 5502760-01 - principal received",1.99352405114,12.717343892353,EUR
"2018-11-24 23:30:00",515026930,"Loan 5503033-01 - interest received",0.069351873898749,12.786695766252,EUR
"2018-11-24 23:30:00",515026977,"Loan 5503033-01 - principal received",1.6138863755417,14.400582141794,EUR
"2018-11-25 01:08:27",515124273,"Loan 6902048-01 - investment in loan  ",-10,4.4005821417937,EUR
